1111111111111
18815000000C1
1880011111001
1P0011E0000T1
1111111111111
